0 0 0 0 0 0 0 0 2 0 0 0 0 0 0 0 0 0
0 1 1 1 1 1 1 1 1 1 1 1 1 1 1 1 1 0
0 1 0 0 0 0 0 0 0 0 0 0 0 0 0 0 1 0
0 1 1 1 0 1 1 1 1 1 0 1 1 1 1 1 1 0
0 1 0 1 0 1 0 0 0 1 0 1 0 0 0 0 0 0 
0 1 0 1 0 1 0 0 0 1 1 1 0 0 0 0 0 0
0 0 0 1 0 1 0 0 0 0 0 0 0 0 0 0 0 0
0 0 0 1 0 1 1 1 1 1 1 1 1 0 0 0 0 0
0 0 0 1 0 0 0 6 0 0 0 0 1 0 0 0 0 0
0 0 0 1 0 0 0 0 0 0 0 0 1 0 0 0 0 0
0 0 0 4 0 0 0 0 0 0 0 0 1 0 0 0 0 0
0 0 0 0 0 0 0 0 0 0 0 0 1 0 0 0 0 0
0 0 0 0 0 0 0 0 0 0 0 0 1 0 0 0 0 0
0 0 0 0 0 0 0 0 0 0 0 0 1 0 0 0 0 0
0 0 7 1 1 1 1 1 1 0 0 0 1 0 0 0 0 0
0 0 0 0 0 0 0 0 1 1 1 1 1 1 1 5 0 0
1 1 1 0 0 0 0 0 1 0 0 0 0 0 0 0 0 0
3 0 1 1 1 1 1 1 1 0 0 0 0 0 0 0 0 0
time:20
__________________________________
0 = Black hole
1 = Path
2 = Start
3 = Goal
4 = Warp1 Start
5 = Warp1 End
6 = Warp2 Start
7 = Warp2 End
* The Time value is in seconds
